================================
=                              =
=                              =
=                              =
=                  ===         =
=                              =
=                              =
=                  ==          =
=                              =
=                              =
=       ====                   =
=                              =
=                =             =
=                              =
=      ===                     =
=                              =
=                              =
================================