================================
=                              =
=                              =
=                              =
=    ====           ===        =
=                              =
=                              =
=                  ==          =
=                              =
=                              =
=       ====                   =
=                              =
=                =             =
=                     +++      =
=      ===            +|+      =
=                      |       =
=                      |       =
================================