=====================================
=                                   =
=                                   =
=                                   =
=    ====           ===             =
=                                   =
=                                   =
=                  ==               =
=                                   =
=                                   =
=       ====                        =
=                                   =
=                =                  =
=                     +++           =
=      ===            +|+           =
=                      |            =
=                      |            =
=====================================