========================================================
=                                                      =
=                                                      =
=                                                      =
=    ====           ===                                =
=                                                      =
=                                                      =
=                  ==                                  =
=                                                      =
=                                                      =
=       ====                                           =
=                                                      =
=                =                                     =
=                     +++                              =
=      ===            +|+                              =
=                      |                               =
=                      |                               =
========================================================