=========================================
=                                       =
=                                       =
=                                       =
=    ====           ===                 =
=                                       =
=                                       =
=                  ==                   =
=                                       =
=                                       =
=       ====                            =
=                                       =
=                =                      =
=                     +++               =
=      ===            +|+               =
=                      |                =
=                      |                =
=========================================